            ░              ╭──────────────────────────────────────╮╳╳╳╳╳╳╳╳╳╳
            ░              ╰╮↓                                   ╭╯╳╳╳╳╳╳╳╳╳╳
            ░               ╰╮                                  ╭╯╳╳╳╳╳╳╳╳╳╳╳
            ░                ╰╮              ╭╦╦╦╦╦╦╦╮         ╭╯╳╳╳╳╳╳╳╳╳╳╳╳
            ░                 ╰╮             ╰┬╩╩╩╩╩╩┴╮       ╭╯╳╳╳╳╳╳╳╳╳╳╳╳╳
            ░                  ╰╮             ╰╮      ╰╮      ╰╮╳╳╳╳╳╳╳╳╳╳╳╳╳
            ░           ╭╦╦╦╦╦╮ ╰╮             ╰╮      ╰╮      ╰╮╳╳╳╳╳╳╳╳╳╳╳╳
          ↔ ░         ╭─╯     ╰─╮╰╮             ╰╮      ╰╮      ╰╮╳╳╳╳╳╳╳╳╳╳╳
░░░░░░░░░░╭─╯         │         │ ╰╮             ╰╮  ←   ╰╮      ╰╮╳╳╳╳╳╳╳╳╳╳
          ╰─╮         │       ↑ │  ╰╮             ╰╮      ╰╮      ╰╮╳╳╳╳╳╳╳╳╳
          ╭─╯         ╰─────────╯   ╰╮             ╰╮      ╰╮      ╰╮╳╳╳╳╳╳╳╳
          ╰─╮                        ╰╮             ╰╮      ╰╮      ╰╮╳╳╳╳╳╳╳
╭───╯     ╭─╯                         ╰╮            ╭┴╮      ╰╮      ╰╮╳╳╳╳╳╳
│         ╰─╮                          ├╦╦╦╦╦╦╦╦╦╦╦╦┤ ╰╩╩╩╩╩╩╩┴╮      ╰╮╳╳╳╳╳
│         ╭─╯                ╬╬╬╬╬╬╬   ╰╩╩╩╩╩╩╩╩╩╩╩╩╯          ╰╮      ╰╮╳╳╳╳
╰───╮     ╰─╮                ╰╮    ╰╮                           ╰╮      ╰╮╳╳╳
          ╭─╯                ╭╯    ╭╯                            ╰╮      ╰╮╳╳
          ╰─╮               ╭╯    ╭╯                              ╰╮      ╰╮╳
╭───╯     ╭─╯              ╭╯ →  ╭╯                                ╰╮      ╰╣
│         ╰─╮             ╭╯    ╭╯                                  ╰╮      ╣
│         ╭─╯            ╭╯    ╭╯                                    ╰╮     ╣
╰────╮    ╰─╮           ╭╯    ╭╯               ╭╮╭╮╭╮╭╮╭╮╭╮╭╮╭╮╭╮╭╮╭╮ ╰╮    ╣
          ╭─╯          ╭╯    ╭╯            ╠───╯╰╯╰╯╰╯╰╯╰╯╰╯╰╯╰╯╰╯╰╯│  ╰╮   ╣
 →        ╰─╮         ╭╯    ╭╯             ╠               ↑        │   ╰╮  ╣
╭────╯    ╭─╯        ╭╯╬╬╬ ╭╯              ╠───╮╭╮╭╮╭╮╭╮╭╮╭╮╭╮╭╮╭╮╭╮│    ╰╮ ╣
│         ╰─╮        ╰─╯ ╰─╯                   ╰╯╰╯╰╯╰╯╰╯╰╯╰╯╰╯╰╯╰╯╰╯     ╰╮╣
│         ╭─╯                                                              ╰╣
╰───────────────────────────────────────────────────────────────────────────╯